{
    "width":48,
    "height":48,
    "map":[ 
4, 4, 4, 4, 4, 4, 4, 4, 4, 4, 4, 4, 4, 4, 4, 4, 4, 4, 4, 4, 4, 4, 4, 4, 4, 4, 4, 4, 4, 4, 4, 4, 4, 4, 4, 4, 4, 4, 4, 4, 4, 4, 4, 4, 4, 4, 4, 4,
4, 1, 1, 1, 1, 4, 4, 1, 1, 1, 4, 4, 1, 1, 4, 1, 4, 1, 1, 1, 1, 1, 1, 4, 4, 4, 1, 1, 1, 1, 4, 4, 1, 1, 1, 1, 4, 4, 4, 1, 1, 4, 4, 1, 4, 4, 1, 4,
4, 1, 8, 1, 1, 4, 4, 1, 4, 4, 4, 1, 1, 1, 1,33, 4, 4, 4, 4, 4, 4, 1, 4, 1, 1, 1, 4, 4, 4, 4, 4, 1, 4, 4, 1, 4,16, 1, 1,16, 4, 4, 1, 4, 1, 1, 4,
4, 1, 1, 1, 1, 4, 1, 1,16, 1, 4, 4, 4, 4, 4, 1, 1, 1, 1, 4, 1, 4, 1, 4, 1, 4,16, 4, 1, 1, 1, 1, 4, 4, 4, 4, 4, 4, 4, 1, 4, 4, 4, 1, 4, 4, 1, 4,
4, 4, 5, 5, 4, 4, 1, 4, 4, 1, 1,16, 1, 1, 4, 1, 4, 4, 4, 4,16, 4, 1, 4, 4, 4, 1, 4, 1, 4, 4, 1,16,16, 1, 1, 1, 4, 1, 4, 4, 1, 4, 4, 1, 4, 1, 4,
4, 4, 1, 1, 4, 4, 1, 4, 4, 4, 4, 4, 4, 1, 1, 1, 1, 1, 1, 1, 1, 1,16, 4, 1, 4, 1, 1, 1,16, 4,33, 4, 4, 4, 4, 4, 1, 4, 4, 1, 1, 4, 1, 4, 1, 4, 4,
4, 4, 1, 1, 4, 1, 1, 1, 4, 4, 1, 1, 1, 1, 4, 4, 4, 4, 4, 1, 4, 4, 1, 1, 1, 4, 1, 4, 1, 4, 4, 1, 4, 1, 4, 4, 4, 4, 1, 4, 4, 1, 4, 4, 4,20, 4, 4,
4, 4, 1, 1, 4, 1, 4, 1, 1, 4, 4, 4, 4, 4, 4, 4, 4, 1, 4, 1, 4, 4, 1, 4, 4, 4, 1, 4, 1, 1, 4, 1, 4, 1, 4, 1, 1, 4, 1, 4, 1, 4, 1, 1, 1, 1, 4, 4,
4, 4, 1, 1, 4, 1, 4, 4, 1, 1, 1, 1, 1, 1, 1, 1, 4,16, 4,33, 4, 4, 1, 1, 1, 4,16, 4, 4, 4, 4, 1, 1, 1, 4, 1, 4, 4,16, 4, 4, 4, 4, 4, 4, 1, 4, 4,
4, 4, 1, 1, 4, 4,16, 4, 4, 4, 4, 4, 4, 4, 4, 1, 4, 1, 4, 4, 4, 4, 4, 4, 1, 4, 4, 1, 4, 4, 4, 1, 4, 4, 4, 1, 4, 4, 1,16, 1, 1, 4, 1, 1,16,16, 4,
4, 4, 1, 1, 4, 4, 1, 4, 4, 1, 1, 1, 1, 1, 4, 4, 4, 1, 4, 1, 1, 1, 4, 1, 1,16, 4, 4, 1, 1, 4, 1, 4, 4, 1, 4, 4, 4, 1, 4, 4, 1, 4, 4, 4, 4, 1, 4,
4, 4, 1, 1, 4, 1, 1, 4, 4, 1, 4, 4, 4,16, 4, 1, 1, 1, 4, 4, 4,33, 4, 4, 4, 4, 4, 1, 1, 4, 4, 4, 1, 1,16, 4, 4, 1, 4, 4, 4, 4, 1, 1, 1, 4, 1, 4,
4, 4, 1, 1, 4, 1, 1, 1, 1, 4, 4, 4, 4, 1, 4, 4, 4, 1,16, 1, 1, 1, 1, 1, 1, 4, 4, 1, 4, 4, 1, 4, 4, 4, 1, 4, 1, 4, 4, 1, 1, 4, 4, 4, 1, 4, 1, 4,
4, 4, 1, 1, 4, 4, 1, 4,16, 4, 1, 4, 4,16, 1, 1, 1, 1, 4, 4, 4, 4, 4, 4, 1, 4, 1, 4, 4, 1, 4, 1, 4, 4, 1, 4, 4, 1, 4, 4, 4, 1, 4, 4, 4, 4, 1, 4,
4, 4, 1, 1, 4, 1, 1, 4, 1, 4, 1, 4, 4,16, 4, 4, 1, 4, 4, 1, 1, 1, 1, 4, 1, 4, 1, 4, 4, 4, 4, 1, 4, 1, 1, 1, 4, 1,16,16, 4, 1, 1, 4, 1, 4, 1, 4,
4, 4, 1, 1, 4, 4, 1, 4, 4, 4, 1, 4, 4, 1, 4, 1, 1, 4, 4, 1, 4, 4, 1, 4, 1, 4,16, 4, 1, 1, 4, 1, 4, 1, 4, 1, 4, 1, 4, 1, 4, 4, 1, 4, 4, 1, 1, 4,
4, 4, 1, 1, 4, 1, 1, 4, 1, 1, 1, 4, 4, 1, 4, 4, 4, 4, 4, 1, 4, 4, 4, 4, 1, 4, 1, 4, 4, 1, 4,16, 4, 4, 4, 1, 4, 1, 4, 1, 4, 4, 1, 1, 4, 4, 1, 4,
4, 4,10,10, 4, 4, 1, 4, 1, 4, 1, 4, 4, 1, 1, 1, 1, 1, 1, 1, 1, 1, 1, 4, 1, 4, 1, 1,16, 4, 4, 1, 4, 1, 4, 1, 4, 4, 4,16, 1, 1, 4, 4, 1, 1, 4, 4,
4, 1, 1, 1, 1, 4, 1, 4, 4, 4, 1, 4, 1, 1, 4, 1, 4, 4, 4, 4, 4, 4, 4, 4, 1, 4, 1, 4, 4, 4, 1, 4, 4, 1, 4, 1, 4, 1, 1, 1, 4, 1, 4, 1, 4, 4, 1, 4,
4, 1, 1, 1, 1, 4, 4, 1, 4, 4, 1, 4, 4, 4, 4, 1, 4, 4, 4, 4, 4, 1,16, 1, 1, 4, 4, 1, 4, 4, 1, 1, 1, 4, 4, 1, 4,20, 4, 4, 4, 1, 4, 4, 4, 4, 1, 4,
4, 1, 1, 1, 1, 1, 4, 4, 1, 1, 1, 1, 1, 1, 4, 1, 1,16, 1,16, 4, 4, 4, 4, 4, 4, 4, 4, 1, 4,16, 4, 4, 4, 1, 1, 4, 4, 4, 1, 1, 1, 4, 4, 1, 4, 1, 4,
4, 1, 1, 1, 1, 4, 4, 4,16, 4, 1, 4, 4, 4, 4, 1, 4, 1, 4, 1, 1, 1, 1,16, 1, 1, 1, 4,33, 1, 1, 4, 4, 1, 4, 4,16, 4, 4, 1, 4, 4, 1, 1, 4, 4, 1, 4,
4, 4, 4, 1, 4, 4, 1, 1, 1, 4, 4, 4, 4, 1, 4, 1, 4, 4, 4, 1, 4, 4, 1, 4, 4, 1, 4, 4,16, 4, 4, 1, 1,16, 4, 1, 4, 1, 4, 4, 4, 1,16, 4, 4, 1, 1, 4,
4, 1, 4, 1, 4, 1, 1, 4, 1,33, 1, 1, 1, 1, 4,16, 4, 1, 4, 1, 4, 4, 1, 4, 4, 1, 4, 4, 1, 4, 4, 4, 4, 1, 4, 1, 4, 1, 4, 4, 1, 1, 4, 4, 4, 1, 4, 4,
4, 1, 4, 1, 4, 1, 4, 4, 1, 4, 4, 1, 4, 4, 4,33, 1, 1, 4, 1, 4, 4, 4, 1, 4, 4, 4, 4, 1, 4, 1, 1, 4, 1, 4, 1, 4,16, 4, 1, 1, 4, 1, 1,16, 4, 4, 4,
4, 1, 4,16, 4, 4, 4, 4, 1, 4, 4, 1, 4, 4, 4, 1, 4, 4, 4, 1, 1, 4, 4, 1, 1,16, 4, 4, 1, 4, 1, 4, 4, 4, 4, 1, 4, 4, 4, 1, 4, 4, 4, 4, 1, 1, 1, 4,
4, 1, 4, 1, 1, 1,16,20, 1, 1, 4,20, 4, 4, 4, 1, 4, 1, 1, 4,16, 4, 4, 4, 4, 4, 4, 4,16, 1, 1, 4, 1, 1, 1, 1, 1, 4, 4,16, 1, 4, 4, 4, 4, 4, 1, 4,
4, 1, 4,16, 4, 4, 4, 4, 4, 4, 4, 1, 4, 4, 4, 1, 4, 4, 4, 4, 1, 1, 1, 1, 1, 1, 1,16, 4, 1, 4, 4, 1, 4, 4, 1, 4, 4, 4, 4, 1, 4, 1, 1, 1, 4, 1, 4,
4, 1, 4, 1, 4, 1, 1, 1, 1, 1, 4,16, 1, 1, 1, 1, 1, 1, 4, 4, 1, 4, 4, 4, 4, 4, 4,33, 4, 1, 1, 4, 1, 4, 4, 1, 1, 4, 4, 1, 1, 4, 4, 1, 4, 4, 4, 4,
4, 1, 1, 1, 4, 4, 4, 4, 4, 1, 4, 1, 4, 4, 4, 4, 4, 4, 4, 4,16, 4, 4, 1, 4, 4, 4, 1, 4, 4, 4, 4, 1, 4, 1, 1, 4, 4, 4,16, 4, 4, 1, 4, 4, 4, 1, 4,
4, 1, 1, 1, 4, 1, 1, 1,16, 1, 4, 1, 4, 4, 4, 4, 1, 1, 1, 4, 1, 4, 1, 1, 1, 1, 4,16, 4, 4, 1, 4,16, 4, 4,16, 4, 4, 1, 1, 1, 1, 1, 4, 1, 4, 1, 4,
4, 1, 4, 4, 4, 1, 4, 4, 4, 4, 4, 1, 1, 1, 1, 4, 1, 1, 1, 1, 1, 4, 1, 4, 1, 4, 4, 1, 4, 4, 1, 4, 4, 1, 4, 4, 4, 1, 4, 4, 4, 4, 1, 4, 1, 1, 1, 4,
4, 1, 1, 4, 4, 1, 4, 4, 4, 4, 4, 1, 4, 4, 1, 4, 1, 1, 1, 4, 4, 4, 1, 4, 4, 4, 4, 1, 4, 1, 4, 4, 4, 1, 4, 4, 4, 4, 1, 4, 4, 4, 1, 4, 4, 1, 4, 4,
4, 1, 4, 4, 1, 1, 1, 1, 1, 1, 1, 1, 4, 4, 1, 4, 4, 4, 4, 4, 1, 4, 1, 4, 4, 1, 1, 1, 1, 4, 4, 1, 4, 1, 1, 1, 1, 4, 4, 1, 4, 4, 1, 4, 4, 1, 4, 4,
4, 1, 4, 4, 4, 4, 4, 1, 4, 4, 4, 4, 4, 4, 1, 4, 1, 4, 1, 4, 1, 1, 1, 1, 4, 4, 4, 1, 1, 1,16, 1, 4, 1, 4, 4, 4, 1, 4, 1, 4, 4, 4, 1, 4, 1, 4, 4,
4, 1, 4, 1, 1, 1, 1, 1, 4, 4, 4, 4, 1, 4, 1, 4,16, 4,33, 4,16, 4, 4, 4, 4, 4, 4, 1, 4, 1, 4, 4, 4, 1, 4, 1, 4, 4, 1, 1, 1, 1, 4, 4, 1, 4, 4, 4,
4, 1, 4, 1, 4, 4, 4, 1, 1, 1, 1, 1, 1, 4, 1, 4, 4, 1, 1, 4,16, 1, 1, 4, 4, 1, 4, 4, 4, 1, 4,16,16,16, 4, 1, 4, 1, 4, 4,33, 4, 4, 4, 4, 1, 4, 4,
4, 1, 4, 1, 1, 1, 4, 4, 4, 4, 1, 4, 4, 4,16, 4, 4, 4, 1, 4, 4, 4, 4,16, 1, 1, 4, 1, 1, 1, 4, 4, 4, 1, 4, 4, 1, 1, 4,16, 1, 4, 4, 4, 4, 4, 1, 4,
4, 1, 4, 4, 4, 4, 4, 4, 4, 4, 1, 4, 4, 4, 4,16, 4, 4, 1, 1, 1, 1, 4, 4, 4, 1, 4, 1, 4,16, 1, 4, 1, 1, 1, 4, 4, 1, 4, 4, 1, 1, 1, 4, 4,20, 1, 4,
4, 1, 1, 1,16, 1, 1, 1, 1, 1, 1, 1, 4, 1, 1, 4, 1, 4, 1, 4, 4,16, 1, 1, 4, 1, 4, 1, 4, 4, 1, 4, 1, 4, 1, 4, 1, 4,16, 4, 1, 4, 1, 4, 4, 1, 4, 4,
4, 1, 4, 4, 1, 4, 4, 1, 4, 4, 4, 1, 4, 4, 1, 4, 4, 1, 1, 1, 4, 4, 4, 4, 4, 1, 4, 4, 4, 4, 4, 4, 4, 4, 1, 4, 4, 4, 4, 4, 4, 4, 4, 4, 4, 1, 4, 4,
4, 1, 4, 4,20, 4, 1, 1, 4, 1, 1, 1, 4, 4, 1, 4, 4, 4, 1, 1, 1, 1, 1, 1, 1, 1, 1, 4, 1, 1, 1, 1, 1, 1, 4, 4, 1, 1, 1, 1, 4, 4, 1, 1, 1, 1, 1, 4,
4, 4, 1, 4, 1, 4, 1, 4, 4,16, 4, 4, 4, 4, 1, 4, 4, 4, 1, 4, 1, 4, 1, 4, 1, 4, 4, 4, 4, 4, 4, 1, 4, 4, 4, 4, 4, 4, 1, 4, 4, 4, 4, 4, 4, 1, 4, 4,
4, 4, 4, 1, 4,16, 4, 4, 1, 1, 1, 4, 4, 1, 1, 1, 1, 1, 1, 4, 1, 4, 4, 4, 1, 1, 1, 4, 4, 1, 1,16, 4, 4, 4, 4,16, 4, 1, 4, 1, 4, 1, 4, 4, 5, 4, 4,
4, 4, 1, 1, 4, 1, 4, 4, 1,33, 1, 4, 1, 1, 4, 4, 4, 4, 4, 4, 4, 4, 1, 4, 4, 4,16, 4, 4, 4, 4, 1, 1, 1, 1, 1, 1, 4, 4, 1, 4, 4, 1, 4, 1, 1, 1, 4,
4, 1,16, 4, 4, 1, 1, 4, 1, 1, 1, 4, 4, 1, 1, 1,20,16, 1, 1, 1, 1, 4, 4, 4, 1, 4, 4, 4, 1, 1, 1, 4, 4, 4, 4, 1, 1, 1, 4, 4, 4, 1, 5, 1, 7, 1, 4,
4, 4, 1, 1, 4, 4, 1, 4, 4, 4, 4, 4, 1,33, 4, 4, 4, 4, 1, 1, 4, 4, 4, 1, 1, 4, 1, 1, 1, 1, 4, 1, 1, 1, 4, 4, 4, 4, 4, 4, 4, 4, 4, 4, 1, 1, 1, 4,
4, 4, 4, 4, 4, 4, 4, 4, 4, 4, 4, 4, 4, 4, 4, 4, 4, 4, 4, 4, 4, 4, 4, 4, 4, 4, 4, 4, 4, 4, 4, 4, 4, 4, 4, 4, 4, 4, 4, 4, 4, 4, 4, 4, 4, 4, 4, 4
    ],
    "tiles":"tiles1.png",
    "water":"water1.png",
    "entrance":[45,45],
    "multiexit":[[47,47],[2,2]],
    "mobs" : [
        {"kind":"EarthElemental","x":2,"y":16,"level":100},
        {"kind":"EarthElemental","x":3,"y":15,"level":100},
        {"kind":"EarthElemental","x":2,"y":14,"level":100},
        {"kind":"EarthElemental","x":3,"y":13,"level":100},
        {"kind":"EarthElemental","x":2,"y":12,"level":100},
        {"kind":"EarthElemental","x":3,"y":11,"level":100},
        {"kind":"EarthElemental","x":2,"y":10,"level":100},
        {"kind":"EarthElemental","x":3,"y":9,"level":100},
        {"kind":"EarthElemental","x":2,"y":8,"level":100},
        {"kind":"EarthElemental","x":3,"y":7,"level":100},
        {"kind":"EarthElemental","x":2,"y":6,"level":100},
        {"kind":"EarthElemental","x":3,"y":5,"level":100}
    ],
    "items": [
        {"kind":"IronKey","x":22,"y":14},
        {"kind":"Ration","x":22,"y":44,"quantity":2},
        {"kind":"PotionOfLevitation","x":5,"y":45},
        {"kind":"PotionOfLiquidFlame","x":27,"y":1}
    ]
}
