{
   "width":16,
   "height":16,
   "map":[ 4, 4, 4, 4, 4, 4, 4, 4, 4, 4, 4, 4, 4, 4, 4, 4,
           4, 7, 5,14,14,14,14, 4, 1, 1, 1, 5, 1,16, 1, 4,
           4, 1, 4,14,14,14,14, 4, 4, 4, 4, 4,38, 4, 1, 4,
           4, 1, 4,14,14,14,14, 4, 4, 4, 4, 4, 1, 4, 1, 4,
           4, 1, 4, 4, 4, 4, 4, 4, 4, 4, 4, 4, 1, 4, 1, 4,
           4, 1, 1, 1, 1, 1, 1, 1, 1, 5, 1, 1, 1, 4, 1, 4,
           4, 4, 4,16, 4, 4, 4, 4, 4, 4, 4, 4,16, 4, 1, 4,
           4, 4, 4, 1, 1, 1, 1, 1, 5,38, 1, 1, 1, 4, 1, 4,
           4, 4, 4, 4, 4, 4, 4,16, 4, 4, 4, 4, 4, 4, 1, 4,
           4, 4, 4, 4, 4, 4, 4, 1, 4, 4, 4, 4, 4, 4, 1, 4,
           4, 4, 4, 4, 4, 4, 4, 1, 4, 1, 1, 1, 1, 1, 1, 4,
           4, 4, 4, 4, 4, 4, 4, 1, 4, 4, 4,16, 4, 4, 4, 4,
           4, 4,14,14,14, 4, 4, 1,16, 1, 4, 1, 1, 1, 1, 4,
           4, 4,14,14,14, 4, 4, 5, 4, 4, 4, 1,23, 1, 1, 4,
           4, 4,14,14,14,14,10, 1, 1, 1, 4, 1, 1, 1, 8, 4,
           4, 4, 4, 4, 4, 4, 4, 4, 4, 4, 4, 4, 4, 4, 4, 4           
         ],
   "tiles":"tiles1.png",
   "water":"water1.png",
   "entrance":[1,1],
   "exit":[14,14],
   "items" : [
      {"kind":"IronKey","x":3,"y":1},
      {"kind":"Pasty","x":3,"y":14},
      {"kind":"ClothArmor","x":3,"y":12}
 ],
   "objects" : [
      {"kind" : "Sign", "x" : 3, "y" : 1, "text" : "TheFallen_Maze1"}
  ]
}