{
"width":30,
"height":30,
"map":[ 
 4, 4, 4, 4, 4, 4, 4, 4, 4, 4, 4, 4, 4, 4, 4, 4, 4, 4, 4, 4, 4, 16, 4, 4, 4, 4, 4, 4, 4, 4,
 4, 1, 1, 1, 16, 1, 1, 1, 1, 1, 1, 4, 4, 1, 1, 1, 1, 1, 16, 23, 1, 1, 1, 23, 1, 4, 4, 4, 4, 4,
 4, 1, 7, 1, 4, 4, 4, 4, 4, 4, 1, 1, 1, 1, 4, 4, 4, 4, 4, 1, 23, 4, 23, 1, 23, 16, 1, 4, 4, 4,
 4, 1, 1, 1, 4, 4, 4, 4, 4, 4, 1, 4, 4, 1, 1, 1, 1, 20, 4, 23, 1, 1, 23, 23, 23, 4, 1, 4, 4, 4,
 4, 4, 16, 4, 4, 4, 4, 4, 4, 1, 1, 1, 4, 4, 4, 4, 4, 4, 4, 4, 4, 4, 4, 4, 4, 4, 1, 4, 4, 4,
 1, 1, 1, 1, 1, 4, 4, 4, 4, 1, 4, 1, 4, 13, 13, 13, 13, 13, 13, 4, 4, 4, 4, 4, 4, 4, 1, 4, 4, 4,
 1, 1, 41, 1, 1, 4, 4, 4, 4, 1, 4, 1, 4, 13, 13, 13, 13, 13, 13, 4, 4, 4, 4, 4, 4, 16, 1, 4, 4, 4,
 1, 1, 41, 1, 11, 16, 1, 1, 4, 1, 4, 1, 4, 13, 13, 13, 13, 13, 4, 4, 4, 4, 4, 4, 4, 4, 16, 4, 4, 4,
 1, 1, 41, 1, 1, 4, 4, 1, 4, 20, 4, 1, 4, 13, 13, 13, 13, 13, 4, 1, 1, 1, 4, 4, 4, 4, 1, 4, 4, 4,
 1, 1, 41, 1, 1, 1, 4, 1, 4, 4, 4, 16, 4, 13, 13, 13, 13, 13, 4, 1, 4, 1, 4, 1, 1, 4, 1, 4, 4, 4,
 41, 41, 41, 41, 41, 1, 4, 1, 4, 20, 1, 20, 4, 13, 13, 13, 13, 13, 4, 1, 4, 1, 4, 4, 1, 4, 1, 4, 4, 4,
 1, 41, 41, 41, 1, 1, 4, 1, 4, 1, 20, 1, 4, 4, 4, 4, 4, 4, 4, 1, 4, 1, 1, 4, 1, 4, 1, 4, 4, 4,
 1, 1, 41, 1, 1, 4, 4, 1, 4, 1, 4, 1, 16, 1, 1, 1, 1, 1, 16, 1, 4, 16, 4, 4, 1, 1, 1, 4, 4, 4,
 1, 1, 1, 1, 1, 4, 4, 1, 4, 20, 20, 1, 4, 4, 4, 4, 4, 16, 4, 4, 4, 1, 4, 4, 16, 4, 4, 4, 4, 4,
 4, 4, 4, 4, 4, 4, 4, 1, 4, 20, 1, 20, 4, 13, 13, 13, 4, 4, 4, 13, 4, 1, 4, 4, 1, 4, 4, 4, 4, 4,
 4, 4, 4, 1, 1, 1, 1, 1, 4, 20, 20, 1, 4, 13, 13, 13, 13, 13, 13, 13, 4, 1, 4, 4, 1, 4, 4, 4, 4, 4,
 4, 4, 4, 1, 4, 4, 4, 4, 4, 4, 16, 4, 4, 13, 13, 13, 13, 4, 4, 4, 4, 5, 4, 4, 5, 4, 4, 4, 4, 0,
 4, 4, 4, 16, 4, 4, 4, 4, 4, 4, 4, 4, 4, 4, 4, 4, 4, 4, 1, 1, 1, 1, 1, 1, 1, 1, 1, 1, 4, 4,
 1, 38, 38, 1, 1, 1, 38, 1, 18, 4, 1, 1, 1, 4, 1, 1, 1, 4, 1, 1, 1, 4, 1, 1, 4, 1, 1, 1, 4, 4,
 38, 1, 1, 38, 38, 38, 1, 38, 1, 4, 1, 4, 1, 4, 1, 4, 1, 4, 1, 1, 1, 1, 1, 1, 1, 1, 1, 1, 4, 4,
 1, 38, 38, 38, 38, 38, 38, 1, 38, 16, 1, 1, 4, 16, 4, 1, 1, 4, 4, 16, 4, 4, 4, 4, 4, 4, 4, 4, 4, 4,
 38, 38, 1, 38, 1, 38, 38, 1, 1, 4, 1, 4, 1, 4, 1, 4, 1, 4, 4, 1, 4, 13, 13, 13, 13, 13, 13, 13, 13, 4,
 38, 1, 11, 1, 38, 1, 1, 38, 38, 4, 1, 1, 1, 4, 1, 1, 1, 4, 4, 1, 4, 13, 13, 13, 13, 13, 13, 13, 13, 4,
 4, 4, 16, 4, 4, 4, 4, 4, 4, 4, 4, 4, 4, 16, 4, 4, 16, 4, 4, 1, 4, 13, 13, 13, 13, 13, 13, 13, 13, 4,
 4, 4, 1, 4, 4, 4, 4, 4, 4, 4, 4, 4, 4, 1, 4, 4, 1, 4, 4, 1, 4, 13, 13, 13, 13, 13, 13, 13, 13, 4,
 4, 4, 1, 1, 1, 1, 1, 1, 1, 1, 1, 1, 1, 1, 1, 1, 1, 4, 4, 1, 4, 13, 13, 13, 13, 4, 4, 4, 4, 4,
 4, 4, 4, 4, 4, 4, 4, 4, 4, 4, 4, 4, 4, 4, 4, 4, 1, 4, 4, 1, 4, 4, 4, 4, 4, 4, 1, 1, 1, 4,
 4, 1, 4, 4, 4, 4, 4, 4, 4, 4, 4, 4, 4, 4, 4, 4, 16, 4, 4, 1, 1, 1, 1, 1, 10, 10, 1, 8, 1, 4,
 4, 1, 1, 1, 1, 1, 1, 1, 1, 1, 1, 1, 1, 1, 1, 1, 1, 1, 4, 4, 4, 4, 4, 4, 4, 4, 1, 1, 1, 4,
 4, 4, 4, 4, 4, 4, 4, 4, 4, 4, 4, 4, 4, 4, 4, 4, 4, 4, 4, 4, 4, 4, 4, 4, 4, 4, 4, 4, 4, 4
],
"tiles":"tiles1.png",
"water":"water0.png",
"entrance":[2,2],
"exit":[27,27],
"objects":[
{"kind":"Sign","x":22,"y":2,"text":"Sign_Perspective1"},
{"kind":"Sign","x":11,"y":12,"text":"Sign_Perspective2"},
{"kind":"Sign","x":20,"y":18,"text":"Sign_Perpective3"},
{"kind":"Sign","x":24,"y":19,"text":"Sign_Perspective3"}
],
"items":[
{"kind":"IronKey","x":1,"y":27,"quantity":2}
]
}