{
   "width":16,
   "height":16,
   "map":[ 4, 4, 4, 4, 4, 4, 4, 4, 4, 4, 4, 4, 4, 4, 4, 4,
           4, 7, 4, 1, 1, 1, 4, 4, 4, 4, 4, 1, 1, 1, 1, 4,
           4, 1, 5, 1,14, 1,16, 1, 1, 1, 4, 1, 1, 1, 1, 4,
           4, 1, 4, 1, 1, 1, 4, 4, 4, 4, 4, 4, 4, 1, 1, 4,
           4, 1, 4, 4, 4, 4, 4, 4, 1, 1, 1, 1, 4, 1, 1, 4,
           4, 1, 4, 1, 1,35, 4, 4, 1, 4, 4, 1, 4, 1, 1, 4,
           4,63, 5, 1, 1, 1,10, 1, 2, 2, 2,20, 4, 1, 1, 4,
           4,63, 4,37, 2, 2, 4, 4,12, 4, 4, 4, 4, 1, 1, 4,
           4,63, 4,10, 4, 4, 4, 1, 1, 1, 1, 1, 1, 1, 1, 4,
           4,63, 4, 1, 4, 1, 1, 1, 1, 1, 1, 1, 1, 1, 1, 4,
           4, 2, 5, 2, 4, 1, 1, 1, 1, 1, 1, 1, 1, 1, 1, 4,
           4, 1, 4, 4, 4, 1, 1, 1, 1, 1, 1, 1, 1, 1, 1, 4,
           4, 2, 4, 1, 1, 1, 1, 1, 1, 1, 1, 1, 1, 1, 1, 4,
           4, 2, 4, 4, 4, 4, 4, 4, 4, 4, 4, 4, 4, 4, 4, 4,
           4, 2,13, 1, 1, 1, 1, 1, 1, 1, 1, 1, 1, 1, 8, 4,
           4, 4, 4, 4, 4, 4, 4, 4, 4, 4, 4, 4, 4, 4, 4, 4           
         ],
   "tiles":"tiles1.png",
   "water":"water1.png",
   "entrance":[1,1],
   "items": [
      {"kind":"IronKey","x":9,"y":6},
      {"kind":"IronKey","x":9,"y":2},
      {"kind":"Codex","x":4,"y":2,"text":"TheFallen_Maze2a"}
 ],
   "objects" : [
      {"kind" : "Sign", "x" : 1, "y" : 2, "text" : "TheFallen_Maze2b"},
      {"kind" : "Sign", "x" : 13, "y" : 14, "text" : "TheFallen_Maze2c"}
 ]
}